****************
*        *    E*
*    *    *  ***
*    *    *    *
*    *    *    *
*    *    *    *
*S    *        *
****************
