**********************************************
*S    *        *     *     *     *     *     *
*  ****  ****  *  *  *  *  *  *  *  *  *  *  *
*        *  *  *  *  *  *     *  *  *     *  *
*  *******  *  *  *  *  *  ****  *  *******  *
*        *     *  *  *  *     *  *  *        *
*******  ****  ****  *  ****  *  *  *  *******
*        *     *     *  *  *  *  *  *  *     *
*  *******  ****  ****  *  *  *  *  *  ****  *
*  *     *  *     *     *     *     *        *
*  ****  *  *  *  *  *************************
*        *     *  *        *     *           *
*******  ****************  *  *  *  ****  *  *
*        *     *     *  *     *  *     *  *  *
*  *******  *  *  *  *  ****  *******  *  *  *
*           *     *  *     *     *     *  *  *
*******************  *  *  ****  *******  *  *
*     *           *  *  *        *     *  *  *
*  *  *  ****  ****  *  **********  *  *  *  *
*  *        *        *  *     *     *  *  *  *
*  *******************  *  *  *  ****  *  *  *
*           *        *  *  *     *     *  *  *
**********  *  ****  *  *  *******  ****  *  *
*           *  *  *  *  *     *     *     *  *
*  **********  *  *  *  ****  *  ****  ****  *
*  *        *  *     *        *  *     *  *  *
*  *  ****  *  *******  *******  ****  *  *  *
*  *  *     *        *  *        *     *  *  *
*  *  *  **********  *  *  ****  *  ****  *  *
*     *                 *     *     *       E*
**********************************************
